1111111111111111
1000001100000001
1011101101101101
1010000000101101
1010100000001001
1010111001100001
1010000001111001
1000100110001101
1010000000001001
1010000110001001
1010010001011101
1010001100000101
1010000000010101
1011010000010001
1000010000000011
1111111111111111
