7777777777777777
7000000000000007
7000000000000007
7000000000000007
7000000000000007
7000000000000007
7000000000000007
7000000770007707
7070000000007007
7070000770007007
7070070007077707
7070007700000707
7070000000070707
7077070000070007
7000070000000077
7777777777777777
7777777777777777
7000007700000007
7077707707707707
7070000000707707
7070700000007007
7070777007700007
7070000007777007
7000700770007707
7070000000007007
7070000770007007
7070070007077707
7070007700000707
7070000000070707
7077070000070007
7000070000000077
7777777777777777
7777777777777777
7000007700000007
7077707707707707
7070000000707707
7070700000007007
7070777007700007
7070000007777007
7000700770007707
7070000000007007
7070000770007007
7070070007077707
7070007700000707
7070000000070707
7077070000070007
7000070000000077
7777777777777777
7777777777777777
7000007700000007
7077707707707707
7070000000707707
7070700000007007
7070777007700007
7070000007777007
7000700770007707
7070000000007007
7070000770007007
7070070007077707
7070007700000707
7070000000070707
7077070000070007
7000070000000077
7777777777777777
7777777777777777
7000007700000007
7077707707707707
7070000000707707
7070700000007007
7070777007700007
7070000007777007
7000700770007707
7070000000007007
7070000770007007
7070070007077707
7070007700000707
7070000000070707
7077070000070007
7000070000000077
7777777777777777
7777777777777777
7000007700000007
7077707707707707
7070000000707707
7070700000007007
7070777007700007
7070000007777007
7000700770007707
7070000000007007
7070000770007007
7070070007077707
7070007700000707
7070000000070707
7077070000070007
7000070000000077
7777777777777777
7777777777777777
7000007700000007
7077707707707707
7070000000707707
7070700000007007
7070777007700007
7070000007777007
7000700770007707
7070000000007007
7070000770007007
7070070007077707
7070007700000707
7070000000070707
7077070000070007
7000070000000077
7777777777777777
7777777777777777
7000007700000007
7077707707707707
7070000000707707
7070700000007007
7070777007700007
7070000007777007
7000700770007707
7070000000007007
7070000770007007
7070070007077707
7070007700000707
7070000000070707
7077070000070007
7000070000000077
7777777777777777
7777777777777777