2222222222222222
2000000000000002
2000000000000002
2000000000000002
2000000000000002
2000000000000002
2000000000000002
2000000220002202
2020000000002002
2020000220002002
2020020002022202
2020002200000202
2020000000020202
2022020000020002
2000020000000022
2222222222222222
2222222222222222
2000002200000002
2022202202202202
2020000000202202
2020200000002002
2020222002200002
2020000002222002
2000200220002202
2020000000002002
2020000220002002
2020020002022202
2020002200000202
2020000000020202
2022020000020002
2000020000000022
2222222222222222
2222222222222222
2000002200000002
2022202202202202
2020000000202202
2020200000002002
2020222002200002
2020000002222002
2000200220002202
2020000000002002
2020000220002002
2020020002022202
2020002200000202
2020000000020202
2022020000020002
2000020000000022
2222222222222222
2222222222222222
2000002200000002
2022202202202202
2020000000202202
2020200000002002
2020222002200002
2020000002222002
2000200220002202
2020000000002002
2020000220002002
2020020002022202
2020002200000202
2020000000020202
2022020000020002
2000020000000022
2222222222222222
2222222222222222
2000002200000002
2022202202202202
2020000000202202
2020200000002002
2020222002200002
2020000002222002
2000200220002202
2020000000002002
2020000220002002
2020020002022202
2020002200000202
2020000000020202
2022020000020002
2000020000000022
2222222222222222
2222222222222222
2000002200000002
2022202202202202
2020000000202202
2020200000002002
2020222002200002
2020000002222002
2000200220002202
2020000000002002
2020000220002002
2020020002022202
2020002200000202
2020000000020202
2022020000020002
2000020000000022
2222222222222222
2222222222222222
2000002200000002
2022202202202202
2020000000202202
2020200000002002
2020222002200002
2020000002222002
2000200220002202
2020000000002002
2020000220002002
2020020002022202
2020002200000202
2020000000020202
2022020000020002
2000020000000022
2222222222222222
2222222222222222
2000002200000002
2022202202202202
2020000000202202
2020200000002002
2020222002200002
2020000002222002
2000200220002202
2020000000002002
2020000220002002
2020020002022202
2020002200000202
2020000000020202
2022020000020002
2000020000000022
2222222222222222
2222222222222222