0 0 0 0 0 0 0 0 0 0 0 0 0 0 0 0 0 0 0 0 0 0 0 0 0 0 0 0 0 0 0 0 0 0 0 0 0 0 0 0 0 0 0 0 0 0 0 0 0 0 0 0 0 0 0 0 0 0 0 0 0 0 0 0 
0 0 0 0 0 0 0 0 0 0 0 0 0 0 0 0 0 0 0 0 0 0 0 0 0 0 0 0 0 0 0 0 0 0 0 0 0 0 0 0 0 0 0 0 0 0 0 0 0 0 0 0 0 0 0 0 0 0 0 0 0 0 0 0 
0 0 0 0 0 0 0 0 0 0 0 0 0 0 0 0 0 0 0 0 0 0 0 0 0 0 0 0 0 0 0 0 0 0 0 0 0 0 0 0 0 0 0 0 0 0 0 0 0 0 0 0 0 0 0 0 0 0 0 0 0 0 0 0 
0 0 0 0 0 0 0 0 0 0 0 0 0 0 0 0 0 0 0 0 0 0 0 0 0 0 0 0 0 0 0 0 0 0 0 0 0 0 0 0 0 0 0 0 0 0 0 0 0 0 0 0 0 0 0 0 0 0 0 0 0 0 0 0 
0 0 0 0 0 0 0 0 0 0 0 0 0 0 0 0 0 0 0 0 0 0 0 0 0 0 0 0 0 0 0 0 0 0 0 0 0 0 0 0 0 0 0 0 0 0 0 0 0 0 0 0 0 0 0 0 0 0 0 0 0 0 0 0 
0 0 0 0 0 0 0 0 0 0 0 0 0 0 0 0 0 0 0 0 0 0 0 0 0 0 0 0 0 0 0 0 0 0 0 0 0 0 0 0 0 0 0 0 0 0 0 0 0 0 0 0 0 0 0 0 0 0 0 0 0 0 0 0 
0 0 0 0 0 0 0 0 0 0 0 0 0 0 0 0 0 0 0 0 0 0 0 0 0 0 0 0 0 0 0 0 0 0 0 0 0 0 0 0 0 0 0 0 0 0 0 0 0 0 0 0 0 0 0 0 0 0 0 0 0 0 0 0 
0 0 0 0 0 0 0 0 0 0 0 0 0 0 0 0 0 0 0 0 0 0 0 0 0 0 0 0 0 0 0 0 0 0 0 0 0 0 0 0 0 0 0 0 0 0 0 0 0 0 0 0 0 0 0 0 0 0 0 0 0 0 0 0 
0 0 0 0 0 0 0 0 0 0 0 0 0 0 0 0 0 0 0 0 0 0 0 0 0 0 0 0 0 0 0 0 0 0 0 0 0 0 0 0 0 0 0 0 0 0 0 0 0 0 0 0 0 0 0 0 0 0 0 0 0 0 0 0 
0 0 0 0 0 0 0 0 0 0 0 0 0 0 0 0 0 0 0 0 0 0 0 0 0 0 0 0 0 0 0 0 0 0 0 0 0 0 0 0 0 0 0 0 0 0 0 0 0 0 0 0 0 0 0 0 0 0 0 0 0 0 0 0 
0 0 0 0 0 0 0 0 0 0 0 0 0 0 0 0 0 0 0 0 0 0 0 0 0 0 0 0 0 0 0 0 0 0 0 0 0 0 0 0 0 0 0 0 0 0 0 0 0 0 0 0 0 0 0 0 0 0 0 0 0 0 0 0 
0 0 0 0 0 0 0 0 0 0 0 0 0 0 0 0 0 0 0 0 0 0 0 0 0 0 0 0 0 0 0 0 0 0 0 0 0 0 0 0 0 0 0 0 0 0 0 0 0 0 0 0 0 0 0 0 0 0 0 0 0 0 0 0 
0 0 0 0 0 0 0 0 0 0 0 0 0 0 0 0 0 0 0 0 0 0 0 0 0 0 0 0 0 0 0 0 0 0 0 0 0 0 0 0 0 0 0 0 0 0 0 0 0 0 0 0 0 0 0 0 0 0 0 0 0 0 0 0 
0 0 0 0 0 0 0 0 0 0 0 0 0 0 0 0 0 0 0 0 0 0 0 0 0 0 0 0 0 0 0 0 0 0 0 0 0 0 0 0 0 0 0 0 0 0 0 0 0 0 0 0 0 0 0 0 0 0 0 0 0 0 0 0 
0 0 0 0 0 0 0 0 0 0 0 0 0 0 0 0 0 0 0 0 0 0 0 0 0 0 0 0 0 0 0 0 0 0 0 0 0 0 0 0 0 0 0 0 0 0 0 0 0 0 0 0 0 0 0 0 0 0 0 0 0 0 0 0 
0 0 0 0 0 0 0 0 0 0 0 0 0 0 0 0 0 0 0 0 0 0 0 0 0 0 0 0 0 0 0 0 0 0 0 0 0 0 0 0 0 0 0 0 0 0 0 0 0 0 0 0 0 0 0 0 0 0 0 0 0 0 0 0 
0 0 0 0 0 0 0 0 0 0 0 0 0 0 0 0 0 0 0 0 0 0 0 0 0 0 0 0 0 0 0 0 0 0 0 0 0 0 0 0 0 0 0 0 0 0 0 0 0 0 0 0 0 0 0 0 0 0 0 0 0 0 0 0 
0 0 0 0 0 0 0 0 0 0 0 0 0 0 0 0 0 0 0 0 0 0 0 0 0 0 0 0 0 0 0 0 0 0 0 0 0 0 0 0 0 0 0 0 0 0 0 0 0 0 0 0 0 0 0 0 0 0 0 0 0 0 0 0 
0 0 0 0 0 0 0 0 0 0 0 0 0 0 0 0 0 0 0 0 0 0 0 0 0 0 0 0 0 0 0 0 0 0 0 0 0 0 0 0 0 0 0 0 0 0 0 0 0 0 0 0 0 0 0 0 0 0 0 0 0 0 0 0 
0 0 0 0 0 0 0 0 0 0 0 0 0 0 0 0 0 0 0 0 0 0 0 0 0 0 0 0 0 0 0 0 0 0 0 0 0 0 0 0 0 0 0 0 0 0 0 0 0 0 0 0 0 0 0 0 0 0 0 0 0 0 0 0 
0 0 0 0 0 0 0 0 0 0 0 0 0 0 0 0 0 0 0 0 0 0 0 0 0 0 0 0 0 0 0 0 0 0 0 0 0 0 0 0 0 0 0 0 0 0 0 0 0 0 0 0 0 0 0 0 0 0 0 0 0 0 0 0 
0 0 0 0 0 0 0 0 0 0 0 0 0 0 0 0 0 0 0 0 0 0 0 0 0 0 0 0 0 0 0 0 0 0 0 0 0 0 0 0 0 0 0 0 0 0 0 0 0 0 0 0 0 0 0 0 0 0 0 0 0 0 0 0 
0 0 0 0 0 0 0 0 0 0 0 0 0 0 0 0 0 0 0 0 0 0 0 0 0 0 0 0 0 0 0 0 0 0 0 0 0 0 0 0 0 0 0 0 0 0 0 0 0 0 0 0 0 0 0 0 0 0 0 0 0 0 0 0 
0 0 0 0 0 0 0 0 0 0 0 0 0 0 0 0 0 0 0 0 0 0 0 0 0 0 0 0 0 0 0 0 0 0 0 0 0 0 0 0 0 0 0 0 0 0 0 0 0 0 0 0 0 0 0 0 0 0 0 0 0 0 0 0 
0 0 0 0 0 0 0 0 0 0 0 0 0 0 0 0 0 0 0 0 0 0 0 0 0 0 0 0 0 0 0 0 0 0 0 0 0 0 0 0 0 0 0 0 0 0 0 0 0 0 0 0 0 0 0 0 0 0 0 0 0 0 0 0 
0 0 0 0 0 0 0 0 0 0 0 0 0 0 0 0 0 0 0 0 0 0 0 0 0 0 0 0 0 0 0 0 0 0 0 0 0 0 0 0 0 0 0 0 0 0 0 0 0 0 0 0 0 0 0 0 0 0 0 0 0 0 0 0 
0 0 0 0 0 0 0 0 0 0 0 0 0 0 0 0 0 0 0 0 0 0 0 0 0 0 0 0 0 0 0 0 0 0 0 0 0 0 0 0 0 0 0 0 0 0 0 0 0 0 0 0 0 0 0 0 0 0 0 0 0 0 0 0 
0 0 0 0 0 0 0 0 0 0 0 0 0 0 49 49 49 49 0 0 0 0 0 0 0 0 0 0 0 0 0 0 0 0 0 0 0 0 0 0 0 0 0 0 0 0 0 0 0 0 0 0 0 0 0 0 0 0 0 0 0 0 0 0 
0 0 0 0 0 0 0 0 0 0 0 0 0 0 57 57 57 57 0 0 0 0 0 0 0 0 0 0 0 0 0 0 0 0 0 0 0 0 0 0 0 0 0 0 0 0 0 0 0 0 0 0 0 0 0 0 0 0 0 0 0 0 0 0 
0 0 0 0 0 0 0 0 0 0 0 0 0 0 0 0 0 0 0 0 0 0 0 0 0 0 0 0 0 0 0 0 0 0 0 0 0 0 0 0 0 0 0 0 0 0 0 0 0 0 0 0 0 0 0 0 0 0 0 0 0 0 0 0 
46 47 0 0 0 0 0 0 0 0 0 0 0 0 0 0 0 0 0 0 0 0 0 0 0 0 0 0 0 0 48 48 48 48 48 48 48 0 0 0 0 0 0 0 0 0 0 0 0 0 0 0 0 0 0 0 0 0 0 0 0 0 0 0 
70 79 0 0 0 0 0 0 0 0 0 0 0 0 0 0 0 0 0 0 0 0 0 0 0 0 0 0 0 0 56 56 56 56 56 56 56 0 0 0 0 0 0 0 0 0 0 0 0 0 0 0 0 0 0 0 0 0 0 0 0 0 0 0 
101 71 0 0 0 0 0 0 0 0 0 0 0 0 0 0 0 0 0 0 0 0 0 0 0 0 0 0 0 0 0 0 0 0 0 0 0 0 0 0 0 0 0 0 0 0 0 0 0 0 0 0 0 0 0 0 0 0 0 0 0 0 0 0 
101 79 0 0 0 0 0 0 0 0 0 0 0 0 0 0 0 0 0 0 0 0 0 0 0 0 0 0 0 0 0 0 0 0 0 0 0 0 0 0 0 0 0 0 0 0 0 0 0 0 0 0 0 0 0 0 0 0 0 0 0 0 0 0 
101 71 0 0 0 0 0 0 0 0 0 0 0 0 0 0 0 0 0 0 0 0 0 0 0 0 0 0 0 0 0 0 0 0 0 0 0 0 0 0 0 0 0 0 0 0 0 0 0 0 0 0 0 0 0 0 0 0 0 0 0 0 0 0 
101 79 0 0 0 0 0 0 72 73 74 73 0 0 45 46 46 46 46 46 46 46 47 0 0 0 0 59 45 46 46 46 46 46 46 47 0 0 0 0 0 0 45 46 46 46 46 46 46 46 47 0 0 0 0 0 0 0 0 0 0 0 0 0 
101 71 0 0 0 0 0 0 80 0 0 0 0 0 53 0 0 0 0 0 0 0 55 83 0 0 0 59 53 0 0 0 0 0 0 55 0 0 0 0 0 0 53 104 104 0 104 0 104 104 55 0 0 0 0 0 0 0 0 0 0 0 0 0 
101 79 0 0 0 0 21 0 136 88 81 0 0 21 61 85 62 62 62 62 62 62 63 0 0 0 0 59 61 85 62 62 62 62 62 63 0 0 0 0 0 0 61 120 112 0 120 0 120 112 63 0 0 0 0 0 0 0 0 0 0 0 0 0 
101 71 0 0 0 0 0 0 144 145 145 145 0 0 53 69 101 70 70 101 70 77 71 0 0 0 0 59 53 69 70 101 101 70 101 71 0 0 0 0 0 0 53 128 112 50 128 50 128 112 55 0 0 0 0 0 0 0 0 0 0 0 0 0 
101 79 0 0 0 0 21 0 152 153 153 153 0 21 61 69 101 101 77 78 101 70 79 0 0 0 0 59 61 69 101 101 101 101 77 79 0 0 0 0 0 0 61 128 112 50 128 50 128 112 63 0 0 0 0 0 0 0 0 0 0 0 0 0 
101 71 0 0 0 0 0 0 152 153 153 153 0 0 53 69 101 101 70 101 101 101 71 0 0 0 0 84 53 69 101 101 101 101 70 71 0 0 0 0 0 0 53 108 139 58 108 58 108 139 55 0 0 0 0 0 0 0 0 0 0 0 0 0 
101 79 0 0 0 0 21 0 152 153 153 153 0 21 61 69 78 101 101 78 77 78 79 0 0 0 0 84 61 69 101 77 78 101 101 79 0 0 0 0 0 0 61 108 139 116 108 116 108 139 63 0 0 0 0 0 0 0 0 0 0 0 0 0 
101 71 0 0 0 0 0 0 160 153 161 153 0 0 53 85 86 86 87 87 87 86 55 83 0 0 0 59 53 85 86 87 86 86 87 55 0 0 0 0 0 0 53 108 0 139 139 0 139 0 55 0 0 0 0 0 0 0 0 0 0 0 0 0 
78 79 0 0 0 0 0 0 0 0 0 0 0 0 61 0 0 0 0 0 0 0 63 0 0 0 0 59 61 0 0 0 0 0 0 63 0 0 0 0 0 0 61 108 0 0 139 139 0 139 63 0 0 0 0 0 0 0 0 0 0 0 0 0 
102 102 0 0 0 0 102 102 102 102 103 102 102 102 102 102 102 102 102 102 102 102 102 103 50 0 0 0 102 102 102 102 102 102 102 102 50 0 0 0 0 0 53 108 121 121 139 122 122 139 55 0 0 0 0 0 0 0 0 0 0 0 0 0 
64 64 64 65 0 0 59 72 74 73 74 74 73 0 0 0 0 0 0 0 0 0 0 0 0 0 0 0 0 0 0 0 0 0 0 0 0 0 0 0 0 0 61 108 129 137 0 130 138 139 63 0 0 0 0 0 0 0 0 0 0 0 0 0 
0 0 83 0 0 0 59 80 88 82 0 0 83 0 0 0 0 0 0 0 0 0 0 0 0 0 0 0 0 0 0 0 0 0 0 0 0 0 0 0 0 0 53 108 137 139 0 138 122 0 55 0 0 0 0 0 0 0 0 0 0 0 0 0 
0 0 83 0 0 72 59 80 81 0 0 103 83 76 65 65 0 0 0 0 0 0 0 0 96 96 96 0 89 0 90 0 0 0 0 0 0 0 0 0 0 0 61 108 139 0 0 139 138 0 63 0 0 0 0 0 0 0 0 0 0 0 0 0 
88 81 83 0 0 80 0 117 118 117 117 118 117 0 0 0 0 0 0 0 0 0 0 0 96 96 96 75 97 143 70 0 84 0 0 0 96 96 96 0 0 0 102 102 102 102 102 102 102 102 102 0 0 0 0 0 0 0 0 0 0 0 0 0 
149 149 149 149 0 80 125 125 125 125 125 125 125 44 44 44 0 0 0 0 0 0 0 0 66 0 0 0 97 69 78 0 84 109 139 0 0 0 0 0 0 0 0 0 0 0 0 0 0 0 0 0 0 0 0 0 0 0 0 0 0 0 0 0 
157 157 157 157 50 133 133 133 133 133 133 133 133 52 52 52 0 0 0 48 48 48 48 48 110 0 103 66 44 44 44 44 44 108 0 0 0 0 0 0 0 0 46 46 46 46 46 46 46 0 0 0 0 0 0 0 0 0 0 0 0 0 0 0 
157 157 157 157 50 76 76 75 76 75 0 0 0 60 60 60 0 0 0 56 56 56 56 56 88 0 0 82 52 52 52 52 52 108 0 21 0 0 0 0 0 0 0 0 0 0 0 0 0 0 0 0 0 0 0 96 96 96 96 0 0 0 0 0 
90 0 90 157 75 88 67 82 0 0 0 64 0 0 0 65 0 0 0 0 49 49 49 0 102 107 102 102 60 60 60 60 60 0 0 0 0 0 0 0 0 0 136 0 0 150 151 0 0 0 0 0 0 0 0 96 96 96 96 0 0 0 0 0 
99 0 0 157 67 88 0 0 83 110 0 0 0 0 0 0 0 0 0 0 57 57 57 0 0 0 73 107 76 75 76 76 76 75 0 0 0 0 0 0 0 0 146 136 0 0 0 0 0 0 0 0 0 45 46 46 46 46 46 46 47 0 0 0 
99 0 0 50 44 44 44 44 44 44 50 0 103 149 21 0 0 0 0 0 72 73 74 73 0 0 66 0 66 0 0 82 105 106 0 49 49 49 49 0 0 0 154 146 148 147 148 148 147 0 0 0 0 53 0 51 51 0 51 0 55 0 0 0 
118 118 118 50 52 52 52 52 52 52 50 149 0 0 0 0 0 0 0 0 80 81 0 84 20 88 0 88 0 0 103 0 113 114 0 57 57 57 57 0 0 0 154 154 156 155 156 156 155 0 0 0 0 61 0 0 0 0 0 0 63 0 0 0 
125 125 125 50 52 52 52 52 52 52 0 157 149 149 149 149 0 0 0 0 136 66 66 84 0 118 117 118 117 118 117 118 117 118 76 65 65 64 64 0 0 0 154 154 164 163 164 164 163 0 0 0 0 53 0 0 0 0 0 0 55 0 0 0 
133 133 133 50 52 52 52 52 52 52 0 157 157 157 157 157 0 0 0 20 144 145 145 145 0 125 125 125 125 125 125 125 125 125 0 0 0 0 0 0 0 0 154 154 164 163 164 164 163 0 0 0 0 61 0 0 0 0 0 0 63 0 0 0 
0 0 0 0 60 60 60 60 60 60 50 157 157 157 0 157 22 0 0 0 152 153 153 153 50 133 133 133 133 133 104 104 104 104 157 149 149 149 149 0 0 0 0 154 164 163 164 164 163 0 0 0 0 102 102 102 102 102 102 102 102 0 0 0 
0 0 0 50 60 60 60 68 68 60 50 0 157 165 157 157 50 0 0 0 160 161 161 153 50 0 0 142 0 0 112 112 112 112 157 165 157 162 157 50 0 0 20 154 164 163 162 162 163 0 0 0 0 0 0 0 0 0 0 0 0 0 0 0 
0 0 0 0 0 0 0 0 0 0 0 0 0 0 0 0 0 0 0 0 0 0 0 0 0 0 0 0 0 0 128 128 128 128 0 0 0 0 0 0 0 0 0 0 0 0 0 0 0 0 0 0 0 0 0 0 0 0 0 0 0 0 0 0 
0 0 0 0 0 0 0 0 0 0 0 0 0 0 0 0 0 0 0 0 0 0 0 0 0 0 0 0 0 0 0 0 0 0 0 0 0 0 0 0 0 0 0 0 0 0 0 0 0 0 0 0 0 0 0 0 0 0 0 0 0 0 0 0 
0 0 0 0 0 0 0 76 75 75 76 76 76 76 0 0 0 0 0 0 0 0 64 65 65 64 64 0 0 0 0 0 0 0 0 0 0 0 0 0 0 0 0 0 0 0 0 0 0 0 0 0 0 0 0 0 0 0 0 0 0 0 0 0 
0 0 0 0 0 0 0 88 67 0 0 82 0 83 0 0 0 0 0 0 0 0 0 0 0 0 0 0 0 0 0 0 0 0 0 0 0 0 0 0 0 0 0 0 0 0 0 0 0 0 0 0 0 0 0 0 0 0 0 0 0 0 0 0 
